11111111111111111111111111111111111111111111111111
11111111111111111111111111111111111111111111111111
11111111111111111111111111111111111111111111111111
11111111111111111111111111111111111111111111111111
11111111111111111111111410041111111111111111111111
11111111111111111111114111114111111111111111111111
11111111111111111111001111111411111111111111111111
11114411114411100111111111111141144111144111441111
21111111111111111111111111111114111111111111111113
00000000001100000000000000001100011000011000110000